Ag: adjectival morpheme. 
a: adjective.
ad: Adjective with the attribute of adverb. Adjective used as adverbial. 
an: Adjective with the attribute of noun. Adjective used as noun.
ap: WTF is ap?
az: WTF is az? 
b: Classifying word.
bz: WTF is bz? 
c: conjunction. 
Dg: adverbial morpheme.
d: Adverb.
d1: WTF is d1?
d2: WTF is d2?
e: Exclamation.
f: directional word. 
g: Morpheme. Most morphemes can be the "root" of a compound word. 
h: element on the left side. 
i: Idiom. 
j: Abbreviation. 
k: Element on the right side.
l: Habitually used expressions which are not idioms and only provisional. 
m: Numeral. 
Ng: Nominal morpheme. 
n: Noun. 
nr: Personal name. 
ns: Place name. 
nt: Institution and Group.
nx: WTF is nx?
nz: Any other proper names.
o: Onomatopoeia. 
p: Preposition. 
q: Quantifier. 
r: Pronoun. 
s: Space. 
Tg: Temporal morpheme. 
t: Time. 
u: Auxiliary.
Ug: WTF is Ug?
Vg: Verbal morpheme. 
v: Verb. 
vd: Verb with the attribute of adverb. 
vi?: WTF is vi?
vn: Verb with the attribute of noun. 
w: Punctuation.
x: non-morpheme character. 
Yg: WTF is Yg?
y: Modality. 
ys: WTF is ys?
z: Stative word. 